$background_0-0.png
   -1   -1   -1   -1   -1   -1   -1   -1   -1   -1   -1   -1   -1   -1   -1   -1   -1   -1   -1   -1   -1   -1   -1   -1   -1   -1
   -1    0    0    0    0    0    0   -1   -1    0    0    0   -1    0    0    0    0    0    0    0    0    0    0    0    0    0 
   -1    0   -20  -20   0    0    0    0   -1   -1    0    0    0    0    0    0    0    0    0    0    0    0    0    0    0    0 
   -1    0    0    0    0    0    0    0    0    0    0    0    0    0   -1    0    0    0    0    0    0    0    0    0    0    0 
   -1    0    0    0   -1   -1    0    0    0    0    0   -1    0    0   -1    0    0    0    0    0    0    0    0    0    0    0
   -1    0    0    0    0    0    0   -1   -1    0    0    0    0    0   -1   -1   -1    0    0    0    0    0    0    0    0    0
   -1    0   -1   -1    0    0    0    0    0   -1   -1   -1   -1   -1   -1    0    0    0    0    0    0    0    0    0    0    0 
   -1   -1    0    0    0    0    0    0    0    0    0    0    0    0    0    0    0    0    0    0    0    0    0    0    0    0
   -1    0    0    0   -1    0    0    0    0    0    0    0    0    0   -1   -1    0    0    0    0    0    0    0    0    0    0
   -1    0    0   -1    0   -1   -1   -1    0    0    0    0    0    0    0    0    0    0    0    0    0    0    0    0    0    0
   -1    0   -1   -1    0    0    0    0   -1   -1   -1    0    0    0    0    0    0    0    0    0    0    0    0    0    0    0
   -1    0    0    0   -1   -1    0   -1   -1   -1    0   -1   -1    0    0    0    0    0    0    0    0    0    0    0    0    0
   -1    0    0    0   -1   -1   -1    0    0    0    0    0    0    0    0    0    0    0    0    0    0    0    0    0    0    0
   -1    0    0    0    0    0    0    0    0    0    0    0    0    0    0    0    0    0    0    0    0    0    0    0    0    0 
   -1    0    0    0    0    0    0    0    0    0    0    0    0    0    0    0    0    0    0    0    0    0    0    0    0    0
   -1    0    0    0    0    0    0    0    0    0    0    0    0    0    0    0    0    0    0    0    0    0    0    0    0    0  

  

$background_0-1.png
   -1   -1   -1   -1   -1   -1   -1   -1   -1   -1   -1   -1   -1   -1   -1   -1   -1   -1   -1   -1   -1   -1   -1   -1   -1   -1
    0    0    0    0    0    0    0    0    0    0    0    0    0    0    0    0    0    0    0    0    0    0    0    0    0    0 
    0    0    0    0    0    0    0    0    0    0    0    0   -1   -1    0    0    0    0    0    0    0    0    0    0    0    0 
    0    0    0    0    0    0    0    0    0    0    0    0  -51    0    0    0    0    0    0    0    0    0    0    0    0    0
    0    0    0    0    0    0    0   -1    0    0    0    0    0    0    0    0    0    0    0    0    0    0    0    0    0    0
    0    0    0    0    0    0    0    0    0    0    0   -1    0    0   -1    0    0    0    0    0    0    0    0    0    0    0
    0    0    0    0    0    0    0    0    0    0    0    0    0    0    0    0    0    0    0    0    0    0    0    0    0    0 
    0    0    0  -26   -1   -1    0    0   -1    0   -1    0   -1   -1    0   -1    0   -1    0    0   -1   -1  -50    0    0    0
    0   -1    0    0    0    0    0    0    0    0    0    0   -1   -1    0    0    0    0    0    0    0    0    0    0   -1    0
    0    0    0    0    0    0    0    0    0    0    0    0    0    0    0    0    0    0    0    0    0    0    0    0    0    0
    0    0    0    0    0    0    0    0    0    0    0    0    0    0    0    0    0    0    0    0    0    0    0    0    0    0
    0    0    0    0    0    0    0    0    0    0    0    0    0    0    0    0    0    0    0    0    0    0    0    0    0    0
    0    0    0    0    0    0    0    0    0    0    0    0    0    0    0    0    0    0    0    0    0    0    0    0    0    0
    0    0    0    0    0    0    0    0    0    0    0    0    0    0    0    0    0    0    0    0    0    0    0    0    0    0 
    0    0    0    0    0    0    0    0    0    0    0    0    0    0    0    0    0    0    0    0    0    0    0    0    0    0
    0    0    0    0    0    0    0    0    0    0    0    0    0    0    0    0    0    0    0    0    0    0    0    0    0    0  

 

$background_0-2.png
   -1   -1   -1   -1   -1   -1   -1   -1   -1   -1   -1   -1   -1   -1   -1   -1   -1   -1   -1   -1   -1   -1   -1   -1   -1   -1
    0    0    0    0    0   -1   -1   -1   -1   -1   -1   -1   -1   -1   -1   -1   -1   -1   -1   -1   -1   -1   -1   -1   -1   -1
    0    0    0    0    0    0   -1   -1   -1   -1   -1   -1   -1   -1   -1   -1   -1   -1   -1   -1   -1   -1   -1   -1   -1   -1
    0    0    0    0    0  -24    0   -1   -1   -1   -1   -1   -1   -1   -1   -1   -1   -1   -1   -1   -1   -1   -1   -1   -1   -1
    0    0    0    0    0    0    0    0   -1   -1   -1   -1   -1   -1   -1   -1   -1   -1   -1   -1   -1   -1   -1   -1   -1   -1 
    0    0    0    0    0    0    0    0    0   -1   -1   -1   -1   -1   -1   -1   -1   -1   -1   -1   -1   -1   -1   -1   -1   -1  
    0    0    0    0    0    0    0    0    0   -1   -1   -1   -1   -1   -1   -1   -1   -1   -1   -1   -1   -1   -1   -1   -1   -1 
    0    0    0    0    0    0    0    0    0    0   -1   -1   -1   -1   -1   -1   -1   -1   -1   -1   -1   -1   -1   -1   -1   -1 
    0    0    0    0    0    0    0    0    0    0    0   -1   -1   -1   -1   -1   -1   -1   -1   -1   -1   -1   -1   -1   -1   -1  
    0    0    0    0    0    0    0    0    0    0    0    0    0    0   -1   -1   -1   -1   -1   -1   -1   -1   -1   -1   -1   -1  
    0    0    0    0    0    0    0    0    0    0    0    0    0    0    0    0    0   -1   -1   -1   -1   -1   -1   -1   -1   -1  
    0    0    0    0    0    0    0    0    0    0    0    0    0    0    0    0    0    0   -1   -1   -1   -1   -1   -1   -1   -1 
    0    0    0    0    0    0    0    0    0    0    0    0    0    0    0    0    0    0    0    0   -1   -1   -1   -1   -1   -1 
    0    0   -1   -1    0    0   -1   -1    0    0    0    0    0    0    0    0    0    0   -1    0    0    0   -1   -1   -1   -1 
    0    0   -1    0    0    0   -1   -1    0    0    0    0    0    0    0    0    0    0    0    0    0    0    0    0   -1   -1
    0    0    0    0    0    0    0    0    0    0    0    0    0    0    0    0    0    0    0    0    0    0    0    0    0   -1


$background_1-0.png
   -1    0    0    0    0    0    0    0    0    0    0    0    0    0    0    0    0    0    0    0    0    0    0    0    0    0
   -1    0    0    0    0    0    0    0    0    0    0    0    0    0    0    0    0    0    0    0    0    0    0    0    0    0 
   -1    0    0    0    0    0    0    0    0    0    0    0    0    0    0    0    0    0    0    0    0    0    0    0    0    0 
   -1    0    0    0    0    0    0    0    0    0    0    0    0    0    0    0   -1    0    0    0    0    0    0    0    0    0 
   -1    0    0    0    0    0   -1   -1   -1   -1   -1    0    0    0    0    0   -1    0    0    0    0    0    0    0    0    0
   -1    0    0    0    0    0   -1   -1   -1   -1   -1    0    0    0    0    0    0    0    0    0    0    0    0    0    0    0
   -1    0    0    0   -1   -1   -1   -1  -12   -1   -1    0    0    0    0    0    0    0    0    0    0    0    0    0    0    0 
   -1   -1   -1   -1   -1    0    0  -52    0    0    0    0    0    0    0    0    0    0    0    0    0    0    0    0    0    0
   -30   0    0    0    0    0    0    0    0    0    0    0    0    0    0    0    0    0    0    0    0    0    0    0    0    0
   -1   -1   -1   -1    0    0    0    0    0    0    0    0    0    0    0    0    0    0    0    0    0    0    0    0    0    0
   -1    0    0    0    0    0    0    0    0    0    0    0    0    0    0    0    0    0    0    0    0    0    0    0    0    0
   -1    0    0    0    0    0    0    0    0    0    0    0    0    0    0    0    0    0    0    0    0   -1   -1    0    0    0
   -1    0    0   -1    0    0    0    0   -1    0    0    0    0    0   -1   -1    0    0    0    0    0    0    0    0    0    0
   -1    0    0   -1    0    0    0    0    0    0    0    0    0    0    0    0    0    0    0    0    0    0    0    0    0    0 
   -1    0    0    0    0    0    0    0    0    0    0    0    0    0    0    0    0    0    0    0    0    0    0    0    0    0
   -1    0    0    0    0    0    0    0    0    0    0    0    0    0    0    0    0    0    0    0    0    0    0    0    0    0 




$background_1-1.png
    0    0    0    0    0    0    0    0    0    0    0    0    0    0    0    0    0    0    0    0    0    0    0    0    0    0 
    0    0    0    0    0    0    0    0    0    0    0    0    0    0    0    0    0    0    0    0    0    0    0    0    0    0 
    0    0    0    0    0    0    0    0    0    0    0    0    0    0    0    0    0    0    0    0    0    0    0    0    0    0 
    0    0    0   -1    0    0    0    0    0    0    0    0    0    0    0    0    0    0    0    0    0    0    0    0    0    0
    0    0    0   -1   -1    0    0    0   -1    0    0    0    0    0    0    0    0    0    0    0    0    0    0    0    0    0 
    0    0    0    0    0    0    0    0    0    0    0    0    0    0    0    0    0    0    0    0   -1    0    0    0   -1    0 
    0    0    0    0    0    0    0    0    0    0    0   -1   -1   -1   -1   -1    0    0    0    0    0    0    0    0    0    0
    0    0    0    0    0   -1   -1   -1   -1   -1    0    0   -1   -10  -1   -1   -1   -1    0    0    0    0    0    0    0    0
    0    0   -1   -1   -1   -1    0    0    0   -1    0    0    0    0    0    0    0    0    0    0    0    0    0    0    0    0 
    0    0   -1    0    0    0    0    0    0   -1    0    0    0    0    0    0    0    0    0    0    0    0    0    0    0    0
    0    0   -1   -1    0   -1   -1   -1   -1   -1    0    0    0    0    0    0    0    0    0    0    0    0   -1   -1    0    0
    0    0    0   -1    0   -1    0    0    0    0    0    0    0    0    0    0    0    0    0    0    0   -1   -1   -1   -1   -1
   -1   -1   -1   -1    0   -1   -1   -1   -1   -1   -1    0    0    0    0    0    0    0    0    0    0    0   -1   -1   -1    0
    0    0    0    0    0    0    0    0    0    0    0    0    0    0    0    0    0    0    0    0    0   -1   -1   -1    0    0
    0    0    0    0    0    0    0    0    0    0    0    0    0    0    0    0    0    0    0    0    0    0   -1   -1   -1    0
    0    0    0    0    0    0    0    0    0    0    0    0    0    0    0    0    0    0    0    0    0    0    0    0    0    0  



$background_1-2.png
    0    0    0    0    0    0    0    0    0    0    0    0    0    0    0    0    0    0    0    0    0    0    0    0    0   -1
    0    0    0    0    0    0    0    0    0    0    0    0    0    0    0    0    0    0    0    0    0    0    0    0    0   -1 
    0    0    0    0    0    0    0    0    0    0    0   -1    0    0    0    0    0    0    0    0    0    0    0    0    0   -1 
    0    0    0   -1   -1    0    0    0    0   -1    0   -1    0    0    0    0    0    0    0    0    0    0    0    0    0   -1 
    0    0    0    0    0    0    0    0    0    0    0   -1    0    0    0    0    0    0    0    0    0    0    0    0    0   -1
    0    0    0    0    0   33   33   33   33   33    0    0    0    0   -1    0    0    0    0    0    0    0    0    0    0   -1
    0    0    0    0    0   33   33   33   33   33    0    0    0    0   -1    0    0    0    0   -1   -1   -1    0    0    0   -1
    0    0    0    0    0   33   33   33   33   33    0    0    0    0   -1    0    0    0    0   -1   -1   -1    0    0    0   -1
    0    0    0    0    0   33   33   33   33   33    0    0    0    0    0    0    0    0   -1    0    0    0    0    0    0   -1
    0    0    0    0    0   33   33   33   33   33    0    0    0    0    0    0    0    0    0    0    0    0    0    0    0   -1
    0    0    0    0    0   33   33   33   33   33    0    0    0    0    0   33   33    0    0    0   33   33    0    0    0   -1
    0    0    0    0    0   33   33   33   33   33    0    0    0    0    0   33   33   33    0   33   33   33    0    0    0   -1
    0    0    0    0    0    0    0    0    0    0    0    0   -1    0    0   33   33   33    0   33   33   33    0    0    0   -1
    0    0   -1    0    0    0    0    0    0    0    0    0    0    0    0   33   33   33    0   33   33   33    0    0    0   -1 
    0    0    0    0    0    0    0    0    0    0    0    0    0    0    0    0    0    0    0    0    0    0    0    0    0   -1
    0    0    0    0    0    0    0    0    0    0    0    0    0    0    0    0    0    0    0    0    0    0    0    0    0   -1 



$background_2-0.png
   -1    0    0    0    0    0    0    0    0    0    0    0    0    0    0    0    0    0    0    0    0    0    0    0    0    0 
   -1    0    0    0    0    0    0    0    0    0    0    0    0    0    0    0    0    0    0    0    0    0    0    0    0    0 
   -1    0    0    0    0    0    0    0    0    0    0    0    0    0    0    0    0    0    0    0    0    0   -1   -1   -1    0 
   -1    0    0    0    0    0    0   -1   -1    0    0    0    0    0    0    0    0    0    0    0    0   -1   -1   -1   -1    0
   -1    0    0    0    0    0    0   -1   -1   -1    0    0    0    0    0    0    0    0    0    0    0    0   -1   -1   -1    0
   -1    0    0    0    0    0    0    0    0    0    0   -1   -1   -1   -1   -1   -1    0    0    0    0   -1   -1   -1   -1    0 
   -1    0   -1   -1   -1    0    0    0    0    0   -1   -1   -1   -1   -1   -1   -1   -1    0    0    0    0    0   -1   -1    0
   -1    0   -1   -1   -1    0    0    0    0   -1   -1   -1   -1   -1   -1   -1   -1   -1    0    0    0    0    0    0    0    0
   -1    0    0    0    0    0    0    0    0   -1   -1   -1   -1   -1   -1   -1   -1   -1   -1    0    0    0    0    0    0    0
   -1    0    0    0    0   40    0    0    0   -1   -1   -1   -1   -1   -1   -1   -1   -1   -1    0    0    0    0   -1   -1    0
   -1    0    0    0    0    0    0    0    0    0   -1   -1   -1   -1   -1   -1   -1   -1   -1    0    0    0   -1   -1   -1    0
   -1    0    0    0    0    0    0    0    0    0    0    0    0   -1   -1   -1   -1   -1   -1    0    0    0   -1   -1    0    0
   -1    0    0    0   -1   -1    0    0    0    0    0    0    0    0   -1   -1   -1   -1    0    0    0    0    0    0    0    0 
   -1    0    0    0    0    0    0    0    0    0    0    0    0    0    0    0    0    0    0    0    0    0    0    0    0    0
   -1    0    0    0    0    0    0    0    0    0    0    0    0    0    0    0    0    0    0    0    0    0    0    0    0    0  
   -1   -1   -1   -1   -1   -1   -1   -1   -1   -1   -1   -1   -1   -1   -1   -1   -1   -1   -1   -1   -1   -1   -1   -1   -1   -1 


   
$background_2-1.png
    0    0    0    0    0    0    0    0    0    0    0    0    0    0    0    0    0    0    0    0    0    0    0    0    0    0 
    0    0    0    0    0    0    0    0    0    0    0    0    0    0   -1    0    0    0    0    0    0    0    0    0    0    0 
    0    0    0    0    0    0    0    0    0    0    0    0    0    0    0    0    0    0    0    0    0    0    0    0    0    0 
    0    0    0    0    0   -1    0    0    0    0    0    0    0    0    0    0    0    0    0    0   -1    0    0    0    0    0  
    0   -1    0    0    0    0    0    0    0    0    0    0   -1   -1    0    0    0    0    0    0    0    0    0    0    0    0
    0    0    0    0    0    0    0    0    0    0    0    0   -1   -1    0    0    0    0    0    0    0    0    0   -1    0    0
    0    0    0    0    0    0    0    0    0    0    0    0    0    0    0    0    0    0    0    0    0    0    0    0    0    0 
    0    0    0    0    0    0    0    0    0    0    0    0    0    0    0    0    0    0    0    0    0    0    0    0    0    0
    0    0    0    0    0    0    0    0    0    0    0    0    0    0    0    0    0    0    0    0    0    0    0    0    0    0
    0    0    0    0    0    0    0    0    0    0    0   -1    0    0   -1    0    0    0    0    0    0    0    0    0    0    0
    0    0    0    0    0    0    0    0    0    0    0   -1    0    0   -1    0    0    0    0    0    0    0    0    0    0    0
    0    0    0    0    0   -1    0    0    0    0    0   -1    0    0   -1    0    0    0    0    0   -1    0    0    0    0    0
    0    0    0    0    0    0    0    0    0    0    0   -1    0    0   -1    0    0    0    0    0    0    0    0    0    0    0
    0    0    0    0    0    0    0    0    0    0    0   -1    0    0   -1    0    0    0    0    0    0    0    0    0    0    0 
    0    0    0    0    0    0    0    0    0    0    0   -1    0    0   -1    0    0    0    0    0    0    0    0    0    0    0  
   -1   -1   -1   -1   -1   -1   -1   -1   -1   -1   -1   -1   -1   -1   -1   -1   -1   -1   -1   -1   -1   -1   -1   -1   -1   -1 


   
$background_2-2.png
    0    0    0    0    0    0    0    0    0    0    0    0    0    0    0    0    0    0    0    0    0    0    0    0    0   -1
    0    0    0    0    0    0    0    0    0    0    0    0    0    0    0    0    0    0    0    0    0    0    0    0    0   -1 
    0    0    0    0    0    0    0    0    0    0    0    0    0    0    0    0    0    0    0    0    0    0    0    0    0   -1 
    0    0    0    0   -1    0    0   -1   -1   -1    0   -1    0    0    0    0    0    0    0    0    0    0   -1    0    0   -1 
    0    0    0    0    0    0    0    0    0    0    0   -1    0    0    0    0    0    0   -1   -1   -1    0    0    0    0   -1
    0    0    0    0    0    0    0    0    0    0    0    0    0    0    0    0    0    0    0    0    0    0    0    0    0   -1
    0    0    0  -27    0    0    0    0    0    0    0    0    0    0    0    0    0    0    0    0    0    0    0    0    0   -1 
    0    0    0    0    0    0    0    0    0    0    0    0    0    0    0    0    0    0    0    0    0    0    0    0    0   -1
    0   -1    0    0   -1   -1   -1    0    0    0    0    0    0    0    0    0    0    0    0    0    0    0    0    0    0   -1
    0    0    0    0    0    0    0    0    0    0    0    0    0    0    0    0    0    0    0    0    0    0    0    0    0   -1
    0    0    0    0    0    0    0    0    0    0    0    0    0    0    0   -1    0    0   -1   -1   -1    0   -1    0    0   -1
    0    0    0    0    0    0    0    0    0    0    0    0    0    0    0    0    0    0    0    0    0    0   -1    0    0   -1
    0    0    0    0    0    0    0    0    0    0    0    0    0    0    0    0    0    0    0    0    0    0    0    0    0   -1
    0    0    0    0    0    0    0    0    0    0    0    0    0    0    0    0    0    0    0    0    0    0    0    0    0   -1 
    0    0    0    0    0    0    0    0    0    0    0    0    0    0    0    0    0    0    0    0    0    0    0    0    0   -1
   -1   -1   -1   -1   -1   -1   -1   -1   -1   -1   -1   -1   -1   -1   -1   -1   -1   -1   -1   -1   -1   -1   -1   -1   -1   -1


   
$background_house.png
    0    0    0    0    0    0    0    0    0    0    0    0    0    0    0    0    0    0    0    0    0    0    0    0    0    0 
    0    0    0    0    0    0    0    0    0    0    0    0    0    0    0    0    0    0    0    0    0    0    0    0    0    0 
    0    0    0    0    0    0    0    0    0    0    0    0    0    0    0    0    0    0    0    0    0    0    0    0    0    0 
    0    0    0    0    0    0    0    0    0    0    0    0    0    0    0    0    0    0    0    0    0    0    0    0    0    0  
    0    0    0    0    0    0   -1   -1   -1   -1   -1   -1   -1   -1   -1   -1   -1   -1   -1   -1    0    0    0    0    0    0
    0    0    0    0    0    0   -1    0    0    0    0    0    0   -1   -1   -1   -1   -1   -1   -1    0    0    0    0    0    0
    0    0    0    0    0    0   -1    0    0    0    0    0    0    0    0    0    0    0   -1   -1    0    0    0    0    0    0
    0    0    0    0    0    0   -1    0    0    0    0    0    0    0    0    0    0    0    0   -1    0    0    0    0    0    0
    0    0    0    0    0    0   -1    0    0    0    0    0    0    0    0    0    0    0    0   -1    0    0    0    0    0    0 
    0    0    0    0    0    0   -1    0    0    0    0    0    0    0    0    0    0    0    0   -1    0    0    0    0    0    0
    0    0    0    0    0    0   -1    0    0    0    0    0    0    0    0    0    0    0    0   -1    0    0    0    0    0    0
    0    0    0    0    0    0   -1    0    0    0    0    0    0    0    0    0    0    0    0   -1    0    0    0    0    0    0
    0    0    0    0    0    0   -1   -1   -1   -1  -11   -1   -1   -1   -1   -1   -1   -1   -1   -1    0    0    0    0    0    0
    0    0    0    0    0    0    0    0    0    0    0    0    0    0    0    0    0    0    0    0    0    0    0    0    0    0 
    0    0    0    0    0    0    0    0    0    0    0    0    0    0    0    0    0    0    0    0    0    0    0    0    0    0 
    0    0    0    0    0    0    0    0    0    0    0    0    0    0    0    0    0    0    0    0    0    0    0    0    0    0 


$background_cave.png
   -1   -1   -1   -1   -1   -1   -1   -1   -1   -1   -1   -1   -1   -1   -1   -1   -1   -1   -1   -1   -1   -1   -1   -1   -1   -1
    0    0    0   -1    0    0    0    0    0    0    0    0    0    0    0    0    0    0    0    0    0   -1    0    0    0   -1 
    0    0    0   -1    0    0    0    0    0    0    0    0    0    0    0    0    0    0    0    0    0   -1    0    0    0   -1 
    0    0   -1    0    0    0    0    0    0    0    0    0    0    0    0    0    0    0    0    0    0    0   -1    0    0   -1 
    0    0   -1    0    0    0    0    0    0    0   -1   -1   -1   -1   -1    0    0    0    0    0    0    0   -1    0    0   -1
    0   -1    0    0    0    0    0    0    0   -1    0    0    0    0    0   -1    0    0    0    0    0    0    0   -1    0   -1
    0   -1    0    0    0    0    0    0    0   -1    0    0   66    0    0   -1    0    0    0    0    0    0    0   -1    0   -1 
    0   -1    0    0    0    0    0    0    0   -1    0    0    0    0    0   -1    0    0    0    0    0    0    0   -1    0   -1
    0   -1    0    0    0    0    0    0    0    0   -1    0    0    0   -1   -1    0    0    0    0    0    0    0   -1    0   -1
    0   -1    0    0    0    0    0    0    0    0   -1   -1    0   -1   -1    0    0    0    0    0    0    0    0   -1    0   -1
    0   -1    0    0    0    0    0    0    0    0    0   -1    0   -1    0    0    0    0    0    0    0    0    0   -1    0   -1
    0   -1    0    0    0    0    0    0    0    0    0   -1    0   -1   -1   -1   -1   -1   -1   -1   -1   -1   -1    0    0   -1
    0   -1   -1    0    0    0    0    0    0    0    0   -1    0    0    0    0    0    0    0    0    0    0    0  -41    0   -1
    0   -1   -1    0    0    0    0    0    0    0    0    0   -25  -1   -1   -1   -1   -1   -1   -1   -1   -1   -1    0    0   -1 
    0    0   -1   -1    0    0    0    0    0    0    0    0    0    0    0    0    0    0    0    0    0   -1    0    0    0   -1
   -1   -1   -1   -1   -1   -1   -1   -1   -1   -1   -1   -1   -1   -1   -1   -1   -1   -1   -1   -1   -1   -1   -1   -1   -1   -1
   
$background_brocoli.png
    0    0    0    0    0    0    0    0    0    0    0    0    0    0    0    0    0    0    0    0    0    0    0    0    0    0 
    0    0    0    0    0    0    0    0    0    0    0    0    0    0    0    0    0    0    0    0    0    0    0    0    0    0 
    0    0    0    0    0    0    0    0    0    0    0    0    0    0    0    0    0    0    0    0    0    0    0    0    0    0 
    0    0    0    0    0    0    0    0    0    0    0    0    0    0    0    0    0    0    0    0    0    0    0    0    0    0  
    0    0    0    0    0    0    0   -1   -1   -1   -1   -1   -1   -1   -1   -1   -1   -1   -1    0    0    0    0    0    0    0
    0    0    0    0    0    0    0   -1   -1   -1   -1   -1    0    0   -1   -1   -1   -1   -1    0    0    0    0    0    0    0
    0    0    0    0    0    0    0   -1   -1    0    0    0    0    0    0    0    0    0   -1    0    0    0    0    0    0    0
    0    0    0    0    0    0    0   -1    0    0    0  -33    0    0    0    0   -1   -1   -1    0    0    0    0    0    0    0
    0    0    0    0    0    0    0   -1    0    0    0    0    0    0    0    0    0    0   -1    0    0    0    0    0    0    0
    0    0    0    0    0    0    0   -1    0    0    0    0    0    0    0    0   -1    0   -1    0    0    0    0    0    0    0
    0    0    0    0    0    0    0   -1    0    0    0    0    0    0    0    0   -1    0   -1    0    0    0    0    0    0    0
    0    0    0    0    0    0    0   -1   -1   -1    0    0    0    0    0    0    0    0   -1    0    0    0    0    0    0    0
    0    0    0    0    0    0    0   -1   -1   -1   -1   -1   -1   -1  -13   -1   -1   -1   -1    0    0    0    0    0    0    0
    0    0    0    0    0    0    0    0    0    0    0    0    0    0    0    0    0    0    0    0    0    0    0    0    0    0 
    0    0    0    0    0    0    0    0    0    0    0    0    0    0    0    0    0    0    0    0    0    0    0    0    0    0 
    0    0    0    0    0    0    0    0    0    0    0    0    0    0    0    0    0    0    0    0    0    0    0    0    0    0 
   