1:2:3:0:0:0:0:0:
4:5:6:0:0:0:0:0:
7:8:9:0:0:0:0:0:
7:8:9:0:0:0:0:0:
7:8:9:0:0:0:0:0:
7:8:9:0:0:0:0:0:
7:8:9:0:0:0:0:0:
7:8:9:0:0:0:0:0:
7:8:9:0:0:0:0:0:
